abfahrt	abfahrt
abfahrtspiste	abfahrtspiste
abfahrtzeiten	abfahrtzeit
abfall	abfall
abfall-	abfall
abfallarmer	abfallarm
abfallbeseitigung	abfallbeseitigung
abfalleimer	abfalleimer
abfallende	abfallend
abfallenden	abfallend
abfallprodukte	abfallprodukt
abfallwirtschaft	abfallwirtschaft
abfallwirtschaftsgesetz	abfallwirtschaftsgesetz
abfassung	abfassung
abfedern	abfedern
abfedert	abfedern
abfeierns	abfeiern
abfertigung	abfertigung
abfertigungen	abfertigung
abfertigungskapazität	abfertigungskapazität
abfinden	abfinden
abfindet	abfinden
abfindung	abfindung
abfindungen	abfindung